01,01,01,01,08,02,09,01,01,01,01,01,01,01,01,08,02,09,01,24,03,27,00,00,00,00,00,00,00,00,00,00
01,01,01,01,08,02,09,01,01,01,01,01,01,01,01,08,02,09,01,24,03,03,27,00,00,00,00,00,00,00,00,00
01,01,01,01,08,02,09,01,01,01,01,01,01,01,01,08,02,09,01,21,03,03,03,27,06,00,00,00,00,00,00,00
01,01,01,01,08,02,09,01,01,01,01,01,01,01,01,08,02,09,01,01,21,03,03,03,03,27,00,00,00,00,00,00
01,01,01,01,08,02,09,01,01,01,01,01,01,01,01,08,02,09,01,01,01,21,11,03,03,03,27,00,00,00,00,00
01,01,01,01,08,02,09,01,01,01,01,01,01,01,01,08,02,09,01,01,01,01,01,21,03,03,03,27,00,00,00,00
01,01,01,01,08,02,09,01,01,01,01,01,01,01,01,08,02,09,01,01,01,01,01,01,21,03,03,03,26,00,00,00
01,01,01,01,08,02,09,01,01,01,01,01,01,01,01,08,02,09,01,01,01,01,01,01,01,21,03,03,26,00,00,00
01,01,01,01,16,02,09,01,01,01,01,01,01,01,01,08,02,02,14,14,14,14,14,19,01,01,21,03,27,00,00,00
01,01,01,01,01,16,02,19,01,01,01,01,01,01,01,16,15,15,15,15,15,02,02,09,01,01,01,21,03,27,06,06
01,01,01,01,01,01,16,02,19,01,01,01,01,01,01,01,01,01,01,01,01,08,02,09,01,01,01,01,21,03,03,03
01,01,01,01,01,01,01,08,02,19,01,01,01,01,01,01,01,01,01,01,01,08,02,09,01,01,01,01,01,21,11,11
14,14,14,14,14,14,14,02,02,02,19,01,01,01,01,01,01,01,01,01,01,08,02,09,01,01,01,01,01,01,01,01
02,02,02,02,02,02,02,02,02,02,02,19,01,01,01,01,01,01,01,01,01,08,02,09,01,01,01,01,01,01,01,01
15,15,15,15,15,15,15,15,15,02,02,09,01,01,01,01,17,14,14,14,14,02,02,09,01,01,01,01,01,01,01,01
01,01,01,01,01,01,01,01,01,08,02,02,14,14,14,14,02,02,02,02,02,02,02,09,01,01,01,01,01,01,01,01
01,01,01,01,01,01,01,01,01,08,02,02,02,02,02,02,15,15,15,15,15,02,02,09,01,01,01,01,01,01,01,01
01,01,01,01,01,01,01,01,01,08,02,09,01,08,02,09,01,01,01,01,01,08,02,02,14,14,14,14,14,14,19,01
12,23,01,01,01,01,01,17,14,02,15,18,01,16,02,02,19,01,01,01,01,08,02,02,02,02,02,02,02,02,09,01
03,07,01,01,01,01,01,08,02,09,01,01,01,01,08,02,09,01,01,01,01,16,15,15,15,15,15,15,02,02,09,01
03,03,23,01,01,01,01,16,15,18,01,01,01,01,08,02,09,01,01,01,01,01,01,01,01,01,01,01,08,02,09,01
25,03,03,12,12,12,23,01,01,01,01,01,01,01,16,02,09,01,01,01,01,01,01,01,01,01,01,01,08,02,09,01
00,25,03,03,03,03,03,12,23,01,01,01,01,01,01,08,02,19,01,01,01,01,01,01,01,01,01,01,08,02,09,01
00,00,25,03,03,03,03,03,03,23,01,01,01,01,01,08,02,09,01,01,01,01,01,01,01,01,01,01,08,02,09,01
00,00,00,05,25,03,03,03,03,03,23,01,01,01,01,08,02,09,01,01,01,01,01,01,01,01,01,01,08,02,09,01
00,00,00,00,00,05,05,25,03,03,03,23,01,01,01,08,02,09,01,01,01,01,01,01,01,01,01,01,08,02,09,01
00,00,00,00,00,00,00,00,25,03,03,07,01,01,01,08,02,09,01,01,01,01,01,01,01,01,01,01,08,02,09,01
00,00,00,00,00,00,00,00,00,25,03,03,23,01,01,16,02,09,01,01,01,01,01,01,01,01,01,01,08,02,09,01
00,00,00,00,00,00,00,00,00,00,25,03,03,23,01,01,08,02,19,01,01,01,01,01,01,01,01,01,08,02,09,01
00,00,00,00,00,00,00,00,00,00,00,25,03,07,01,01,08,02,09,01,01,01,01,01,01,01,01,01,08,02,09,01
00,00,00,00,00,00,00,00,00,00,00,04,03,07,01,01,08,02,09,01,01,01,01,01,01,01,01,01,08,02,09,01
00,00,00,00,00,00,00,00,00,00,00,04,03,07,01,01,08,02,09,01,01,01,01,01,01,01,01,01,08,02,09,01

0,0,0,0,0,0,0,0,0,0,0,0,0,0,0,0,0,0,0,0,0,1,1,0,0,0,0,0,0,0,0,0
0,0,0,0,0,0,0,0,0,0,0,0,0,0,0,0,0,0,0,0,0,0,1,1,0,0,0,0,0,0,0,0
0,0,0,0,0,0,0,0,0,0,0,0,0,0,0,0,0,0,0,0,0,0,0,1,1,1,0,0,0,0,0,0
0,0,0,0,0,0,0,0,0,0,0,0,0,0,0,0,0,0,0,0,0,0,0,0,0,1,1,0,0,0,0,0
0,0,0,0,0,0,0,0,0,0,0,0,0,0,0,0,0,0,0,0,0,0,0,0,0,0,1,1,0,0,0,0
0,0,0,0,0,0,0,0,0,0,0,0,0,0,0,0,0,0,0,0,0,0,0,0,0,0,0,1,1,0,0,0
0,0,0,0,0,0,0,0,0,0,0,0,0,0,0,0,0,0,0,0,0,0,0,0,0,0,0,0,1,0,0,0
0,0,0,0,0,0,0,0,0,0,0,0,0,0,0,0,0,0,0,0,0,0,0,0,0,0,0,0,1,0,0,0
0,0,0,0,0,0,0,0,0,0,0,0,0,0,0,0,0,0,0,0,0,0,0,0,0,0,0,0,1,1,0,0
0,0,0,0,0,0,0,0,0,0,0,0,0,0,0,0,0,0,0,0,0,0,0,0,0,0,0,0,0,1,1,1
0,0,0,0,0,0,0,0,0,0,0,0,0,0,0,0,0,0,0,0,0,0,0,0,0,0,0,0,0,0,0,0
0,0,0,0,0,0,0,0,0,0,0,0,0,0,0,0,0,0,0,0,0,0,0,0,0,0,0,0,0,0,0,0
0,0,0,0,0,0,0,0,0,0,0,0,0,0,0,0,0,0,0,0,0,0,0,0,0,0,0,0,0,0,0,0
0,0,0,0,0,0,0,0,0,0,0,0,0,0,0,0,0,0,0,0,0,0,0,0,0,0,0,0,0,0,0,0
0,0,0,0,0,0,0,0,0,0,0,0,0,0,0,0,0,0,0,0,0,0,0,0,0,0,0,0,0,0,0,0
0,0,0,0,0,0,0,0,0,0,0,0,0,0,0,0,0,0,0,0,0,0,0,0,0,0,0,0,0,0,0,0
0,0,0,0,0,0,0,0,0,0,0,0,0,0,0,0,0,0,0,0,0,0,0,0,0,0,0,0,0,0,0,0
0,0,0,0,0,0,0,0,0,0,0,0,0,0,0,0,0,0,0,0,0,0,0,0,0,0,0,0,0,0,0,0
0,0,0,0,0,0,0,0,0,0,0,0,0,0,0,0,0,0,0,0,0,0,0,0,0,0,0,0,0,0,0,0
0,0,0,0,0,0,0,0,0,0,0,0,0,0,0,0,0,0,0,0,0,0,0,0,0,0,0,0,0,0,0,0
0,0,0,0,0,0,0,0,0,0,0,0,0,0,0,0,0,0,0,0,0,0,0,0,0,0,0,0,0,0,0,0
1,0,0,0,0,0,0,0,0,0,0,0,0,0,0,0,0,0,0,0,0,0,0,0,0,0,0,0,0,0,0,0
1,1,0,0,0,0,0,0,0,0,0,0,0,0,0,0,0,0,0,0,0,0,0,0,0,0,0,0,0,0,0,0
0,1,1,0,0,0,0,0,0,0,0,0,0,0,0,0,0,0,0,0,0,0,0,0,0,0,0,0,0,0,0,0
0,0,1,1,1,0,0,0,0,0,0,0,0,0,0,0,0,0,0,0,0,0,0,0,0,0,0,0,0,0,0,0
0,0,0,0,1,1,1,1,0,0,0,0,0,0,0,0,0,0,0,0,0,0,0,0,0,0,0,0,0,0,0,0
0,0,0,0,0,0,0,1,1,0,0,0,0,0,0,0,0,0,0,0,0,0,0,0,0,0,0,0,0,0,0,0
0,0,0,0,0,0,0,0,1,1,0,0,0,0,0,0,0,0,0,0,0,0,0,0,0,0,0,0,0,0,0,0
0,0,0,0,0,0,0,0,0,1,1,0,0,0,0,0,0,0,0,0,0,0,0,0,0,0,0,0,0,0,0,0
0,0,0,0,0,0,0,0,0,0,1,1,0,0,0,0,0,0,0,0,0,0,0,0,0,0,0,0,0,0,0,0
0,0,0,0,0,0,0,0,0,0,0,1,0,0,0,0,0,0,0,0,0,0,0,0,0,0,0,0,0,0,0,0
0,0,0,0,0,0,0,0,0,0,0,1,0,0,0,0,0,0,0,0,0,0,0,0,0,0,0,0,0,0,0,0